.#..............##....#.#.####.
##..........#.....##...........
.......#....##...........#.#...
.........#.#...#..........#....
.........#..#................##
..#...#..#..#...........#......
...................#...##..##..
........#.....##...#.#.#...#...
#..#.##......#.#..#..........#.
......#.#...#.#...#........##.#
.....#.####........#...........
...###..#............#.........
.....#.......##......#...#.....
#......##......................
......#..............#.........
..##...#....###.##.............
#...#..........#.#.........#...
...........#........#...#......
.....##.........#......#..#....
#..............#....#.....#....
.#......#....#...#............#
.####..........##..#.#.........
....#...#......................
....................#....#.#...
..........###.#...............#
.#...........#...##............
.#.#..#.....#...#....#.......#.
.##........#..#....#...........
.........#.....#......###......
..............#..#.......#.....
........#..#.#...........#..#..
#.........#......#.....##.#.#..
........#.#.#....#.............
........#........#.#.##........
#......#.#..........#..#.......
..#....#...##......###..#..#...
............#..#.#.........#...
....#.#...........#..........##
.......#.#.#..#......#...#.....
..#.........##.#.........#...#.
......#....#.#....#........#.#.
.#....###....#..............#..
.#....#.......#....#..#.....#..
.....#.....#...................
..#.....#......#......#........